09 10 10 10 10 10 10 10 10 10 10 10 10 08 09 10 10 10 10 10 10 10 10 10 10 10 10 08
03 44 44 44 44 44 44 44 44 44 44 44 44 25 24 44 44 44 44 44 44 44 44 44 44 44 44 02
03 44 23 15 15 22 44 23 15 15 15 22 44 25 24 44 23 15 15 15 22 44 23 15 15 22 44 02 
03 44 25 44 44 24 44 25 44 44 44 24 44 25 24 44 25 44 44 44 24 44 25 44 44 24 44 02
03 44 27 20 20 26 44 27 20 20 20 26 44 27 26 44 27 20 20 20 26 44 27 20 20 26 44 02
03 44 44 44 44 44 44 44 44 44 44 44 44 44 44 44 44 44 44 44 44 44 44 44 44 44 44 02
03 44 23 15 15 22 44 23 22 44 23 15 15 15 15 15 15 22 44 23 22 44 23 15 15 22 44 02
03 44 27 20 20 26 44 25 24 44 27 20 20 34 33 20 20 26 44 25 24 44 27 20 20 26 44 02
03 44 44 44 44 44 44 25 24 44 44 44 44 25 24 44 44 44 44 25 24 44 44 44 44 44 44 02
05 12 12 12 12 22 44 25 36 15 15 22 44 25 26 44 23 15 15 06 24 44 23 12 12 12 12 04
44 44 44 44 44 03 44 25 34 20 20 26 44 26 25 44 26 20 20 08 24 44 03 44 44 44 44 44
44 44 44 44 44 03 44 25 24 44 44 44 44 44 44 44 44 44 44 25 24 44 02 44 44 44 44 44
44 44 44 44 44 03 44 25 24 44 29 12 12 44 44 32 12 28 44 25 24 44 02 44 44 44 44 44
10 10 10 10 10 26 44 27 26 44 02 44 44 44 44 44 44 03 44 27 26 44 27 10 10 10 10 10
44 44 44 44 44 44 44 44 44 44 02 44 44 44 44 44 44 03 44 44 44 44 44 44 44 44 44 44
12 12 12 12 12 22 44 23 22 44 02 44 44 44 44 44 44 03 44 23 22 44 23 12 12 12 12 12
44 44 44 44 44 03 44 25 24 44 31 10 10 10 10 10 10 30 44 25 24 44 02 44 44 44 44 44
44 44 44 44 44 03 44 25 24 44 44 44 44 44 44 44 44 44 44 25 24 44 02 44 44 44 44 44
44 44 44 44 44 03 44 25 24 44 23 15 15 15 15 15 15 22 44 25 24 44 02 44 44 44 44 44 
01 10 10 10 10 26 44 27 26 44 27 10 10 35 34 10 10 26 44 27 26 44 27 10 10 10 10 00
03 44 44 44 44 44 44 44 44 44 44 44 44 25 24 44 44 44 44 44 44 44 44 44 44 44 44 02
03 44 23 15 15 22 44 23 15 15 15 22 14 25 24 44 23 15 15 15 22 44 23 15 15 22 44 02
03 44 27 20 35 24 44 27 20 20 20 26 44 27 26 44 27 20 20 20 26 44 25 34 20 26 44 02
03 44 44 44 25 24 44 44 44 44 44 44 44 44 44 44 44 44 44 44 44 44 25 24 44 44 44 02
36 15 22 44 25 24 44 23 22 44 23 15 15 15 15 15 15 22 44 23 22 44 25 24 44 23 15 37
42 20 26 44 27 26 44 25 24 44 27 20 20 35 34 20 20 26 44 25 26 44 27 26 44 27 20 35
03 44 44 44 44 44 44 25 24 44 44 44 44 25 24 44 44 44 44 25 24 44 44 44 44 44 44 02
03 44 23 15 15 15 15 37 36 15 15 22 44 25 24 44 23 15 15 37 36 15 15 15 15 22 44 02
03 44 44 27 20 20 20 20 20 20 20 20 26 44 27 26 44 27 44 44 44 44 44 44 44 26 44 02
03 44 44 44 44 44 44 44 44 44 44 44 44 44 44 44 44 44 44 44 44 44 44 44 44 44 44 02
05 12 12 12 12 12 12 12 12 12 12 12 12 12 12 12 12 12 12 12 12 12 12 12 12 12 12 04